
SO /Users/ren-nasr/Wolfenstein-3D/resources/textures/example.xpm
NO /Users/ren-nasr/Wolfenstein-3D/resources/textures/example.xpm
WE /Users/ren-nasr/Wolfenstein-3D/resources/textures/example.xpm
EA /Users/ren-nasr/Wolfenstein-3D/resources/textures/example.xpm

F 255,100,0
C 100,23,33

1111111111111
1001101010101
1000101010101
1010010010101
1111111111111