
SO ./resources/textures/example.xpm
NO ./resources/textures/example.xpm
WE ./resources/textures/example.xpm
EA ./resources/textures/example.xpm

F 255,100,0
C 100,23,33

1111111111111
1N00101010101
1010001000001
1010100010001
1000001001001
1111111111111
