
SO ./resources/textures/wood.xpm
NO ./resources/textures/stone1.xpm
WE ./resources/textures/stone2.xpm
EA ./resources/textures/wall.xpm

F 105,105,105
C 135,206,235

11111111111111111111111
1S001001010101000010011
11010100101010101001101
10000000100000000000101
10000100100010000000001
11111111111111111111111
