
SO ./resources/textures/south.xpm
NO ./resources/textures/north.xpm
WE ./resources/textures/west.xpm
EA ./resources/textures/east.xpm

F 255,255,255
C 100,23,33


1111111111111111111111
111111111111110000000011
1N1010001    1000000001111
100000001111111000000011
10010000000000000000011
10001000000000000000001
10000000000100000000001
11010100101010101001101
10000000100000000000101
10000000000000000000001
11111111111111111111111
