

SO ./resources/textures/nazi.xpm
NO ./resources/textures/redbrick.xpm
WE ./resources/textures/hitler.xpm
EA ./resources/textures/steelwall.xpm

F 105,105,105
C 135,206,235


1111111111111111111111111111
1010101010101010101010101011
1000100010001000100010001001
1211111111121111111111112111
1000000010000000100000000001
1010101000000000001010101011
1010101010001100101010101011
1211111111121111111111112111
1000000000000000000000000001
100000001000N000100000000001
1000000000000000000000000001
1010101010000000101010101011
1010101010000000111010101011
1211111111121111111111112111
1000000010000000100000000001
1010101010101010101010101011
1211111211121111111111111211
1020000000100000000000200011
1111111111111111111111111111