
SO ./resources/textures/south.xpm
NO ./resources/textures/north.xpm
WE ./resources/textures/west.xpm
EA ./resources/textures/east.xpm

F 155,118,83
C 100,23,33

11111111111111111111111
11101000000000000000000111111
100N000000100000000000111121
1000000000100100000001100001
10000000010100000000000110111
1000000100100000010000000111
1100000000001000100110111111
10000000100000000001001
10001000000000000000001
11111111111111111111111
